{
  "map": [
    "10000001",
    "10000011",
    "10100001",
    "10000101",
    
    "10000001",
    "10000001",
    "10001001",
    "10000001",
    
    "10100001",
    "10000011",
    "10000001",
    "11000011",
  ]
}